OOOOOOOOOOOOOOOOOOO
O       O         O
O OOOOO O OOOOOOO O
O O   O O O       O
O O O O O O OOOOO O
O   O   O       O O
OOOOOOOOOOOOOOO O O
O             O   O
O OOOOOOOOOOO OOO O
O O       O     O O
O O OOOOO O OOOOO O
O O O     O     O O
O O O OOOOOOOOO O O
O             O   O
OOOOOOOOOOOOOOOOOOO