OOOOOOOOOOOOOOOOOOOOOOO
O       O     O       O
O OOOOO   OOO   OOOOO O
O     O O   O O     O O
O OOO   O O   O OOO   O
O     O   O O       O O
O OOOOOOO   OOOOOOO O O
O       O O O       O O
O OOOOO       OOOOO O O
O       O O O       O O
O OOOOOOO   OOOOOOO O O
O       O O O       O O
O OOO O   O   O OOO O O
O     O OOOOO O     O O
O OOO           OOO   O
O     OOOO OOOO     O O
OOOOOOOOOOOOOOOOOOOOOOO