OOOOOOOOOOOOOOOOOOO
O       O         O
O OOOOO O O   OOO O
O O   O   O       O
O   O   O O OOOOO O
O   O   O       O O
OO OOOOOOOO OOO O O
O   O       O     O
O OOO OOOOOOO OOO O
O O       O     O O
O   OOOOO   OOOOO O
O O O     O     O O
O O   OOOOOOO O O O
O             O   O
OOOOOOOOOOOOOOOOOOO