------------------------------------------
|*     |           |          |          |
|      |           |          |          |
| ---  |                      |          |
|                                        |
|                  -                    *|
|--------------  --|-------    ----------|
|                  |           |         |
|                  |           |*        |
|-------   --------|           |-----    |
|      |   |       |                     |
|     *|   |      *|                     |
|  ----|   |--   --|           ----------|
|                  |           |         |
|                  |                    *|
|---------------   |-----------   -------|
|*     |           |          |          |
|      |           |          |          |
| ---  |                      |          |
|                                        |
|                  -                    *|
|--------------  --|-------    ----------|
|                  |           |         |
|                  |           |*        |
|-------   --------|           |-----    |
|      |   |       |                     |
|     *|   |      *|                     |
|  ----|   |--   --|           ----------|
|                  |           |         |
|                  |                    *|
|------------------|---------------------|