OOOOOOOOOOOOOOO
O      *      O
O  OOOOOOOOO  O
O             O
O OOO     OOO O
O             O
O     OOO     O
O             O
OOOO       OOOO
O             O
O   OOO OOO   O
O             O
O OOO     OOO O
O             O
O    OOOOO    O
O             O
O  OO     OO  O
O             O
O      O      O
O             O
O OOO     OOO O
O             O
O  OO     OO  O
O             O
O    OOOOO    O
O             O
O O         O O
O             O
OO           OO
O             O
OOOOO     OOOOO
O             O
O             O
OOOOOOOOOOOOOOO